####################
#..................#
#..............#...#
#..............#...#
#..............#...#
#..............#...#
#..............#...#
#..................#
#..................#
#........###.......#
#..................#
#........$.........#
#..................#
#..................#
#..................#
#...#########......#
#..................#
#..................#
#..................#
####################