####################
#..................#
#...#..........#...#
#...#..........#...#
#...####.......#...#
#...#..........#...#
#...#..........#...#
#..................#
#..................#
#........###.......#
#..................#
#........$.........#
#..................#
#..................#
#..................#
#...#########......#
#...........#......#
#...........#......#
#..................#
####################